60 27 62 62 24 67 68 68 68 68 90 49 49 49 49 86 69 69 69 69 46 129 139 139 139 139 132 43 128 30 30 30 31 31 31 31 31 31 31 31 31 31 31 31 31 31 31 51 46 62 62 62 62 62 62 62 62 62 62 62 62 62 62 62
64 62 62 62 62 23 23 23 23 24 48 49 49 49 49 51 27 23 23 23 122 123 139 139 139 139 132 43 128 30 30 30 31 31 31 31 31 31 31 31 31 31 31 31 31 31 31 51 46 62 62 62 62 62 62 62 62 62 62 62 62 62 62 62
62 62 62 62 62 62 62 62 62 43 67 69 69 69 69 70 46 62 62 129 139 139 139 139 139 139 133 43 128 30 30 30 31 31 31 31 31 31 31 31 31 31 31 31 31 31 31 51 46 62 62 62 62 62 62 62 62 62 62 62 62 62 62 62
62 62 62 62 62 62 62 39 62 62 23 23 23 23 23 23 62 20 62 129 139 119 139 139 139 139 132 43 128 30 30 30 31 31 31 31 31 31 31 31 31 31 31 31 31 31 31 51 46 62 62 62 62 62 62 62 62 62 62 62 62 62 62 62
62 62 62 62 62 62 62 62 62 62 62 62 62 21 62 62 62 62 62 129 139 139 139 83 149 149 62 43 128 30 30 30 31 31 31 31 31 31 31 31 31 31 31 31 31 31 31 51 46 62 62 62 62 62 62 62 62 62 62 62 62 62 62 62
62 62 62 62 62 62 62 62 62 62 62 62 62 62 62 62 91 122 122 123 139 139 139 132 62 62 62 43 29 30 31 30 31 31 31 31 31 31 31 31 31 31 31 31 31 31 31 51 46 62 62 62 62 62 62 62 62 62 62 62 62 62 62 62
62 62 62 62 40 62 62 62 62 62 62 62 62 62 62 62 129 139 139 139 139 139 139 132 62 62 62 43 29 31 31 31 31 31 31 31 31 31 31 31 31 31 31 31 31 31 31 51 46 62 62 62 62 62 62 62 62 62 62 62 62 62 62 62
62 62 62 62 62 62 62 62 62 62 62 62 62 62 62 62 129 139 139 139 139 139 139 132 62 62 62 43 29 31 31 31 31 31 31 31 31 31 31 31 31 31 31 31 31 31 31 51 46 62 62 62 62 62 62 62 62 62 62 62 62 62 62 62
62 62 62 62 62 62 41 58 58 80 62 62 62 62 91 122 123 139 139 139 83 150 150 151 62 62 62 43 29 31 31 31 31 31 31 31 31 31 31 31 31 31 31 31 31 31 31 51 46 62 62 62 62 62 62 62 62 62 62 62 62 62 62 62
62 62 62 62 62 62 41 27 24 38 62 62 62 62 129 139 139 138 139 139 132 62 62 62 62 62 62 43 29 31 31 31 31 31 31 31 31 31 31 31 31 31 31 31 31 31 31 51 46 62 62 62 62 62 62 62 62 62 62 62 62 62 62 62
58 58 59 58 58 59 60 46 43 38 62 62 62 62 129 139 139 139 139 139 132 62 91 92 92 94 62 43 48 31 31 31 31 31 31 31 31 31 31 31 31 31 31 31 31 31 31 51 46 62 62 62 62 62 62 62 62 62 62 62 62 62 62 62
23 23 23 23 23 64 64 62 43 38 39 62 62 62 129 139 139 139 83 150 151 62 129 139 139 132 62 43 67 68 68 68 68 68 68 68 68 68 68 68 68 68 68 68 68 68 68 70 46 62 62 62 62 62 62 62 62 62 62 62 62 62 62 62
62 39 62 62 62 62 82 62 43 38 62 62 62 62 129 139 139 139 132 62 62 62 129 139 139 132 62 62 64 64 64 64 63 63 63 63 63 63 63 63 63 63 63 63 63 63 63 63 62 62 62 62 62 62 62 62 62 62 62 62 62 62 62 62
62 62 91 92 92 94 62 62 43 38 62 62 62 62 129 139 139 139 132 62 40 62 148 150 150 151 62 62 62 62 62 62 62 62 62 62 62 62 62 62 62 62 62 62 62 62 62 62 62 62 62 62 62 62 62 62 62 62 62 62 62 62 62 62
62 62 129 139 139 132 62 62 43 38 62 62 62 62 129 139 139 139 132 62 62 62 62 62 62 62 62 62 62 62 62 82 62 62 62 62 62 62 62 62 62 62 62 62 62 62 62 62 62 62 62 62 62 62 62 62 62 62 62 62 62 62 62 62
62 62 129 139 139 132 62 62 43 38 62 62 62 62 148 84 84 84 151 62 62 62 62 62 62 62 62 62 62 62 62 62 62 62 62 62 62 62 62 62 62 62 62 62 62 62 62 62 62 62 62 62 62 62 62 62 62 62 62 62 62 62 62 62
62 62 148 149 149 151 62 62 43 38 62 62 62 82 62 62 62 62 62 62 62 62 62 62 62 40 62 62 62 62 62 62 62 62 62 62 62 62 62 62 62 62 62 62 62 62 62 62 62 62 62 62 62 62 62 62 62 62 62 62 62 62 62 62
62 62 62 62 62 62 62 62 43 38 62 62 62 62 62 62 91 92 92 94 62 62 62 62 62 82 62 62 62 62 62 30 30 62 62 82 62 62 62 62 20 62 62 62 62 62 62 62 62 62 62 62 62 62 62 62 62 62 62 62 62 62 62 62
136 136 136 136 136 136 136 136 136 137 62 62 62 62 62 62 110 139 139 132 62 62 62 62 62 62 62 62 62 62 62 30 30 62 62 62 62 62 62 62 62 62 62 62 62 62 62 62 62 62 62 62 62 62 62 62 62 62 62 62 62 62 62 62
62 62 62 20 62 62 62 62 62 62 62 62 62 62 62 62 110 138 139 132 62 62 62 62 62 62 62 62 62 62 62 62 62 62 62 62 62 62 62 62 62 62 62 62 62 62 62 62 62 62 62 62 62 62 62 62 62 62 62 62 62 62 62 62
62 62 62 62 62 62 62 62 62 62 62 62 62 62 62 62 148 149 149 151 62 62 91 92 92 94 62 62 62 62 62 62 62 62 62 62 62 62 62 62 62 62 62 62 62 62 62 62 62 62 62 62 62 62 62 62 62 62 62 62 62 62 62 62
62 62 62 62 62 62 62 62 62 40 62 62 62 62 62 62 62 62 62 62 62 62 110 139 139 132 62 62 62 62 62 62 62 62 62 62 62 62 62 62 62 62 62 62 62 62 62 62 62 62 62 62 62 62 62 62 62 62 62 62 62 62 62 62
62 62 62 62 62 62 62 62 62 62 62 62 62 62 62 62 62 62 62 62 62 62 110 139 139 132 62 62 62 62 62 62 62 62 62 62 62 62 62 62 62 62 62 62 62 62 62 62 62 62 62 62 62 62 62 62 62 62 62 62 62 62 62 62
62 62 62 62 62 62 62 62 62 62 62 62 62 62 62 62 62 62 62 62 62 62 110 139 139 132 62 62 62 62 62 62 62 82 62 20 62 62 62 62 62 62 62 62 62 62 62 62 62 62 62 62 62 62 62 62 62 62 62 62 62 62 62 62
62 62 62 62 62 62 62 62 62 62 62 62 62 62 62 62 62 62 62 62 62 62 110 139 139 132 62 62 62 62 62 62 62 62 62 62 62 62 62 62 62 62 62 62 62 62 62 62 62 62 62 62 62 62 62 62 62 62 62 62 62 62 62 62
62 62 62 62 62 62 62 62 62 62 62 62 62 62 62 62 62 62 62 62 20 62 110 139 139 132 62 62 62 62 62 62 62 62 62 62 62 62 62 62 62 62 82 62 62 62 62 62 62 62 62 62 62 62 62 62 62 62 62 62 62 62 62 62
62 62 62 62 62 62 62 62 62 62 62 62 62 62 62 62 62 62 62 62 62 62 110 139 139 132 62 62 62 62 62 62 62 62 62 62 62 62 62 62 62 62 62 62 62 62 62 62 62 62 62 62 62 62 62 62 62 62 62 62 62 62 62 62
62 62 62 62 62 62 62 62 62 62 62 62 62 62 62 62 62 62 62 62 62 62 110 139 139 132 62 62 62 62 62 62 62 62 62 62 62 62 62 62 62 62 62 62 62 62 62 62 62 62 62 62 62 62 62 62 62 62 62 62 62 62 62 62
62 62 62 62 62 62 62 62 62 62 62 62 62 62 62 62 62 62 62 62 62 62 110 139 139 121 94 62 62 62 62 62 62 62 62 62 62 62 62 62 62 62 62 62 62 62 62 62 62 62 62 62 62 62 62 62 62 62 62 62 62 62 62 62
62 62 62 62 62 62 62 62 62 62 62 62 62 62 62 62 62 62 62 62 62 62 110 139 139 139 132 62 62 62 62 62 62 62 62 62 62 62 62 62 62 62 62 62 62 62 62 62 62 62 62 62 62 62 62 62 62 62 62 62 62 62 62 62
62 62 62 62 62 62 62 62 62 62 62 62 62 62 62 62 62 62 62 62 62 62 110 139 139 139 132 62 62 62 62 62 62 62 62 62 62 62 62 62 62 62 62 62 62 62 62 62 62 62 62 62 62 62 62 62 62 62 62 62 62 62 62 62
62 62 62 62 62 62 62 62 62 62 62 62 62 62 62 62 62 62 62 62 62 62 110 139 139 139 132 62 62 62 62 62 62 62 62 62 62 62 62 62 62 62 62 62 62 62 62 62 62 62 62 62 62 62 62 62 62 62 62 62 62 62 62 62
62 62 62 62 62 62 62 62 62 62 62 62 62 62 62 62 62 62 62 62 62 62 110 139 139 139 132 62 62 62 62 62 62 62 62 62 62 62 62 62 62 62 62 62 62 62 62 62 62 62 62 62 62 62 62 62 62 62 62 62 62 62 62 62
62 62 62 62 62 62 62 62 62 62 62 62 62 62 62 62 62 62 62 62 62 62 110 139 139 139 132 62 62 62 62 62 62 62 62 62 62 62 62 62 62 62 62 62 62 62 62 62 62 62 62 62 62 62 62 62 62 62 62 62 62 62 62 62
62 62 62 62 62 62 62 62 62 62 62 62 62 62 62 62 62 62 62 62 62 62 110 139 139 139 132 62 62 62 62 62 62 62 62 62 62 62 62 62 62 62 62 62 62 62 62 62 62 62 62 62 62 62 62 62 62 62 62 62 62 62 62 62
62 62 62 62 62 62 62 62 62 62 62 62 62 62 62 62 62 62 62 62 62 62 110 139 139 139 132 62 62 62 62 62 62 62 62 62 62 62 62 62 62 62 62 62 62 62 62 62 62 62 62 62 62 62 62 62 62 62 62 62 62 62 62 62