94 94 94 94 94 94 94 94 94 94 94 94 94 94 94 94 94 94 0 0 0 0 0 0 0 0 0 0 0 0 0 0 0 0 0 0 0 0 0 0 
94 94 94 94 94 94 94 94 94 94 94 94 94 94 94 94 94 94 0 0 0 0 0 0 0 0 0 0 0 0 0 0 0 0 0 0 0 0 0 0 
94 94 94 94 94 94 94 94 94 94 94 94 94 94 94 94 94 94 0 0 0 0 0 0 0 0 0 0 0 0 0 0 0 0 0 0 0 0 0 0 
94 94 94 94 94 94 94 94 94 94 94 94 94 94 94 94 94 94 0 0 0 0 0 0 0 0 0 0 0 0 0 0 0 0 0 0 0 0 0 0 
94 94 94 94 94 94 94 94 94 94 94 94 94 94 94 94 94 94 0 0 0 0 0 0 0 0 0 0 0 0 0 0 0 0 0 0 0 0 0 0 
94 94 94 94 94 94 94 94 94 94 94 94 94 94 94 94 94 94 0 0 0 0 0 0 0 0 0 0 0 0 0 0 0 0 0 0 0 0 0 0 
94 94 94 94 94 94 94 94 94 94 94 94 94 94 94 94 94 94 0 0 0 0 0 0 0 0 0 0 0 0 0 0 0 0 0 0 0 0 0 0 
94 94 94 94 94 94 94 94 94 94 94 94 94 94 94 94 94 94 0 0 0 0 0 0 0 0 0 0 0 0 0 0 0 0 0 0 0 0 0 0 
68 68 68 68 68 68 68 68 68 68 90 68 68 93 123 121 94 94 0 0 0 0 0 0 0 0 0 0 0 0 0 0 0 0 0 0 0 0 0 0 
68 68 68 68 79 80 68 68 68 104 68 68 123 121 124 95 94 94 0 0 0 0 0 0 0 0 0 0 0 0 0 0 0 0 0 0 0 0 0 0 
0 0 0 0 0 0 0 0 0 0 0 0 89 95 95 94 94 94 0 0 0 0 0 0 0 0 0 0 0 0 0 0 0 0 0 0 0 0 0 0 
0 0 0 0 0 0 0 0 0 0 0 0 0 94 94 94 94 94 0 0 0 0 0 0 0 0 0 0 0 0 0 0 0 0 0 0 0 0 0 0 
0 0 0 0 0 0 0 0 0 0 0 0 0 94 94 94 94 94 0 0 0 0 0 0 0 0 0 0 0 0 0 0 0 0 0 0 0 0 0 0 
0 0 0 0 0 0 0 0 0 0 0 0 0 94 94 94 94 94 0 0 0 0 0 0 0 0 0 0 0 0 0 0 0 0 0 0 0 0 0 0 
0 0 0 0 0 0 0 0 0 0 0 0 0 94 94 94 94 94 95 95 95 95 95 95 95 95 95 95 95 0 0 0 95 95 95 95 95 95 95 95 
36 36 1 2 3 4 5 6 7 8 9 10 23 94 94 94 94 94 94 94 94 94 94 94 94 94 94 94 94 0 0 0 94 94 94 94 94 94 94 94 
36 36 13 14 15 16 17 18 19 20 21 22 23 94 94 94 94 94 94 94 94 94 94 94 94 94 94 94 94 0 0 0 94 94 94 94 94 94 94 94 
36 36 25 26 27 28 29 30 31 32 33 34 23 94 94 94 94 94 94 94 94 94 94 94 94 94 94 94 94 0 0 0 94 94 94 94 94 94 94 94 
36 36 37 38 39 40 41 42 43 44 45 34 23 94 94 94 94 94 0 0 0 0 0 0 0 0 0 0 0 0 0 0 0 0 0 0 0 0 0 0 
36 48 49 50 51 52 53 54 55 56 57 34 23 94 94 94 94 94 0 0 0 0 0 0 0 0 0 0 0 0 0 0 0 0 0 0 0 0 0 0 
36 60 61 62 63 64 65 66 67 68 68 34 23 94 94 94 94 94 0 0 0 0 0 0 0 0 0 0 0 0 0 0 0 0 0 0 0 0 0 0 
36 60 73 74 68 81 104 68 68 105 68 34 23 94 94 94 94 94 0 0 0 0 0 0 0 0 0 0 0 0 0 0 0 0 0 0 0 0 0 0 
36 60 85 86 68 90 79 80 68 81 69 34 23 94 94 94 94 94 0 0 0 0 0 0 0 0 0 0 0 0 0 0 0 0 0 0 0 0 0 0 
36 60 97 68 104 105 68 68 68 68 69 34 23 94 94 94 94 94 0 0 0 0 0 0 0 0 0 0 0 0 0 0 0 0 0 0 0 0 0 0 
36 60 68 68 68 68 68 68 68 68 69 34 35 94 94 94 94 94 0 0 0 0 0 0 0 0 0 0 0 0 0 0 0 0 0 0 0 0 0 0 
36 60 68 78 68 68 68 78 81 68 68 46 47 94 94 94 94 94 0 0 0 0 0 0 0 0 0 0 0 0 0 0 0 0 0 0 0 0 0 0 
36 60 68 68 81 68 68 68 68 68 68 58 59 94 94 94 94 94 0 0 0 0 0 0 0 0 0 0 0 0 0 0 0 0 0 0 0 0 0 0 
18 72 68 68 68 68 68 68 68 68 68 70 71 94 94 94 94 94 0 0 0 0 0 0 0 0 0 0 0 0 0 0 0 0 0 0 0 0 0 0 
41 96 68 81 68 68 68 68 68 68 68 82 83 94 94 94 94 94 0 0 0 0 0 0 0 0 0 0 0 0 0 0 0 0 0 0 0 0 0 0 
53 108 68 68 68 68 68 68 68 68 68 68 68 94 94 94 94 94 0 0 0 0 0 0 0 0 0 0 0 0 0 0 0 0 0 0 0 0 0 0 
68 68 68 68 79 80 68 68 68 81 68 68 120 0 0 0 0 0 0 0 0 0 0 0 0 0 0 0 0 0 0 0 0 0 0 0 0 0 0 0 
78 68 68 68 68 68 68 68 68 68 92 90 68 0 0 0 0 0 0 0 0 0 0 0 0 0 0 0 0 0 0 0 0 0 0 0 0 0 0 0 
68 81 68 68 113 68 68 68 115 68 68 68 120 0 0 0 0 0 0 0 0 0 0 0 0 0 0 0 0 0 0 0 0 0 0 0 0 0 0 0 
68 114 68 90 68 68 68 113 93 68 68 68 120 95 95 95 95 95 95 95 0 0 0 0 0 0 0 0 0 0 0 0 0 0 0 0 0 0 0 0 
91 104 68 68 68 123 121 121 121 121 121 121 124 94 94 94 94 94 94 94 0 0 0 0 0 0 0 0 0 0 0 0 0 0 0 0 0 0 0 0 
121 121 121 121 121 124 95 95 95 95 95 95 95 94 94 94 94 94 94 94 95 95 0 0 0 0 0 0 0 0 0 0 0 0 0 0 0 0 0 0 
95 95 95 95 95 95 94 94 94 94 94 94 94 94 94 94 94 94 94 94 94 94 0 0 0 0 0 0 0 0 0 0 0 0 0 0 0 0 0 0 
94 94 94 94 94 94 94 94 94 94 94 94 94 94 94 94 94 94 94 94 94 94 95 0 0 0 0 0 0 0 0 0 0 0 0 0 0 0 0 0 
94 94 94 94 94 94 94 94 94 94 94 94 94 94 94 94 94 94 94 94 94 94 94 0 0 0 0 0 0 0 0 0 0 0 0 0 0 0 0 0 
94 94 94 94 94 94 94 94 94 94 94 94 94 94 94 94 94 94 94 94 94 94 94 0 0 0 0 0 0 0 0 0 0 0 0 0 0 0 0 0 